"name","date","total","additions","deletions","sha"
"anaboston","2021-05-28T18:05:57Z",0,0,0,"eba0011c1763f18312d6509b68f00d486287d72e"
"anaboston","2021-05-28T18:05:47Z",0,0,0,"31171cab034a647ed11118f66891af2f8df1d807"
"anaboston","2021-05-28T17:58:08Z",4,3,1,"f27a025bc93aa4cfffc72bb531b548295eb6c0c8"
"anaboston","2021-05-28T17:57:45Z",3,2,1,"511296edf20189629d471ca5b561f7914f65cf74"
"anaboston","2021-05-28T17:54:31Z",52,11,41,"3182224446ab1f9ed60045af84b6f50e0d2884a3"
"anaboston","2021-05-28T17:53:02Z",52,41,11,"66981af4842fc839b7474a910bc56624539f1219"
"anaboston","2021-05-28T17:51:03Z",58,11,47,"b424af4158a0b28dd3459c022221c8eb6107489b"
"SilviaHernandezCuerdas","2021-05-28T17:47:44Z",8,1,7,"9f0aabbfd84e47f1c05fc0e668e5b5436d19fd75"
"anaboston","2021-05-28T17:18:25Z",0,0,0,"75d0c9391bba43a421de4eb696963674bba39647"
"anaboston","2021-05-28T17:17:23Z",0,0,0,"4964b4a1763f20943c1c69fd7eb01032d3a6518b"
"anaboston","2021-05-28T17:17:14Z",0,0,0,"b1e3ecbab31d37b93bdef120a16be93ab7a9db11"
"anaboston","2021-05-28T17:17:00Z",0,0,0,"bd2e8798b140188db2794890ee1533c6da571601"
"SilviaHernandezCuerdas","2021-05-28T17:08:39Z",81,46,35,"c23b8282127398961cd802f1c9db48e3cddb937c"
"anaboston","2021-05-28T16:30:49Z",1260,390,870,"2f44fc3751dc28253359f7101424a9aadbce2a7e"
"SilviaHernandezCuerdas","2021-05-28T16:23:36Z",481,395,86,"c7ac3c21ecde7df256eeab1d933802dd02e7dcba"
"GonzaloGV13","2021-05-28T15:00:00Z",5,2,3,"cb6923adc58df00be44e3308ef8433205be784be"
"GonzaloGV13","2021-05-28T14:59:42Z",1,1,0,"6ee32915926151290fabe9fc45e07a277466ffa6"
"GonzaloGV13","2021-05-28T14:59:26Z",2,1,1,"ad191a62f08ee304c1c9e71b699afdac6406c90f"
"GonzaloGV13","2021-05-28T14:59:17Z",2,1,1,"bb66a23a4c71543b7416e61bbd82720c871ceaae"
"GonzaloGV13","2021-05-28T14:59:06Z",2,1,1,"10c6832e7a30f0d2faef0b20057b3a2bde2a3443"
"GonzaloGV13","2021-05-28T14:58:53Z",172,86,86,"ddfcfa961360c7548c42fe3e93591dc7fe1be527"
"anaboston","2021-05-28T14:29:30Z",0,0,0,"1244ab1963d6111774b4e7ad26cc7e4c1a981122"
"anaboston","2021-05-28T10:00:54Z",0,0,0,"7cd6179e9a8f465095d38a2185e4c7ad1cd804f0"
"anaboston","2021-05-28T09:24:19Z",0,0,0,"43d1467dff8c95979b1295e087a071288d03c7ec"
"anaboston","2021-05-25T21:56:44Z",1,0,1,"506c7fb42e92e00155116cb03a6ddd2e2a4a89cf"
"anaboston","2021-05-25T21:56:25Z",0,0,0,"133922b2faeceb0b796fef051eb57837621992f1"
"anaboston","2021-05-25T21:55:21Z",1,1,0,"84c6b665c590ce6624a7ba527c5eee2e3ef3360c"
"anaboston","2021-05-25T21:38:36Z",1,1,0,"ba968cc03c2d3a7d31b3ea76bda5c5aef2663c32"
"anaboston","2021-05-25T21:37:21Z",784,408,376,"98d0e424780ca29542434c10c2fc3d767e06a34f"
"SilviaHernandezCuerdas","2021-05-25T20:52:21Z",611,579,32,"f4de7e40d2773f6f4d6412f49e84846dd4bc6438"
"GonzaloGV13","2021-05-25T19:15:11Z",2,1,1,"c807d285776d3e9bdd63d20ee1fb23901b0301dd"
"GonzaloGV13","2021-05-25T19:14:59Z",2,1,1,"3f52383155268cd9daaf47f05debf7bc89abf3c6"
"anaboston","2021-05-23T13:25:01Z",6,0,6,"866c58b12406adbb74767dbb9f02c20ab31cac43"
"anaboston","2021-05-23T13:24:40Z",9,9,0,"f553e20b47c4d70c968e134ba25e6a9be9aafff2"
"anaboston","2021-05-22T19:45:01Z",9,5,4,"bf46a81942128be953a249cd21cdf70401ddd7c3"
"anaboston","2021-05-22T19:43:14Z",3,3,0,"0f622c840bf8de309d19751be355d083b6d997bd"
"anaboston","2021-05-22T19:09:04Z",35,18,17,"2e5c09ccafa13d0981cca9ca39a7646ba73ed3d3"
"anaboston","2021-05-22T19:06:36Z",42,41,1,"d9d54d15668fc734e3bfce33ddf6d09af625c293"
"anaboston","2021-05-22T19:02:38Z",2,1,1,"d184b6eb0a12d50ccba90cdbaa6491cb8fa74221"
"SilviaHernandezCuerdas","2021-05-22T18:28:16Z",30,30,0,"db5007b3e12eea0ec298cc8367ba5b4fe3252100"
"SilviaHernandezCuerdas","2021-05-21T08:30:44Z",2,1,1,"51f36fe59c49dc9db895e20323437c61cdb2058b"
"anaboston","2021-05-21T08:28:40Z",2,1,1,"27ada700ece53ad6147c60ca62b7b184f0fddb93"
"anaboston","2021-05-21T08:25:28Z",6,3,3,"098b513d4424423e0de0aa1cc297ea87f91f809d"
"anaboston","2021-05-20T22:44:44Z",36,36,0,"23ac9ffedb4ee37bf6916fd0259d679bc10ca2a8"
"anaboston","2021-05-20T18:40:57Z",0,0,0,"8cf0449998fcfea58db087488ceed96099de391a"
"anaboston","2021-05-20T18:07:43Z",74,49,25,"339bc704941bff69987a9ea5529ad3c1750e1db2"
"anaboston","2021-05-20T16:55:36Z",10,5,5,"0935b4f319df25e4afdde4e8a737b66ef46c7dcb"
"anaboston","2021-05-14T22:07:07Z",87,42,45,"2d204e989b4bb2f775fc76ed9f6ae2078b4c085f"
"anaboston","2021-04-29T22:25:51Z",242,100,142,"869584b0d4c76a6cc9cf3cf5ab6aa172a2476dd1"
"SilviaHernandezCuerdas","2021-04-21T11:25:04Z",2,1,1,"2443380954322fd11b0873b9fd5be21df00b57d1"
"SilviaHernandezCuerdas","2021-04-21T11:24:20Z",2,1,1,"57f643109a792ff66d73411231c9068e8e9805b7"
"anaboston","2021-04-21T11:17:20Z",10,5,5,"a69e998ef8a8edd6c7cea91be1f2f580ed156bdc"
"anaboston","2021-04-21T11:16:25Z",2,1,1,"bf58fbe606124b3b60657d30625e6457250a49fb"
"SilviaHernandezCuerdas","2021-04-21T11:11:37Z",2,1,1,"9bbe0d799ab1f2276f4736f81d1f2661b717d1b5"
"anaboston","2021-04-21T11:08:50Z",2,1,1,"921720b9a3f3f03e1dafd92ec407ffa3276ebbf0"
"SilviaHernandezCuerdas","2021-04-21T11:07:54Z",1,1,0,"e3cb97f362d63008b0c60033c88ac2a043302353"
"anaboston","2021-04-21T11:04:14Z",3,1,2,"251ac2bba5493adf43ac7758bc2649578c3c1268"
"anaboston","2021-04-21T11:03:58Z",2,2,0,"77fd5bb84f097587ab609dbecb03a4f34f9d0d03"
"SilviaHernandezCuerdas","2021-04-21T11:01:40Z",3,1,2,"8ba60862bdf1d36f1ac50dcae0fab04a8e3f628a"
"anaboston","2021-04-21T10:59:02Z",2,1,1,"95ae3f6e0a2c7d6b1c6f83bc6eace58e03f6c07c"
"SilviaHernandezCuerdas","2021-04-21T10:53:10Z",2,1,1,"64724504c3a2fef3315c7aadf0ad6349e01093e1"
"GonzaloGV13","2021-04-21T10:39:13Z",24,12,12,"6f9eddea2a320062057e26ee509549ee450f1f66"
"GonzaloGV13","2021-04-21T10:36:38Z",2,1,1,"a122ad80244344a3002df799c85c31d828de084c"
"GonzaloGV13","2021-04-21T10:35:43Z",2,1,1,"e4efd1cc0d5c151b17a17a985097fb5845b182fc"
"GonzaloGV13","2021-04-19T16:51:43Z",2,1,1,"c9f0189a73b97ef956bc787d5e64ea54ed9b6a47"
"anaboston","2021-04-15T23:30:01Z",10,9,1,"38a4dd5d523a76e1b2f8bb8565c531a44e2ee4a9"
"anaboston","2021-04-15T23:14:48Z",113,94,19,"5f30785339e868d638268bb3db3ecad2f1c235d5"
"anaboston","2021-04-15T20:14:30Z",160,96,64,"0e51ab957abfc38e8bf061f747f32fd7153d96cb"
"anaboston","2021-04-04T15:30:12Z",0,0,0,"8bc126cfc45abf9b16d58fffe28b63e3c40b8b1f"
"anaboston","2021-03-23T19:07:09Z",126,126,0,"e6194e295b17667a919149c156d024f8d4088cac"
"GonzaloGV13","2021-03-18T16:36:50Z",2,1,1,"d7dade9e00dfe32cb8400bc00e47ddd462661cfe"
"anaboston","2021-03-16T18:29:36Z",6,5,1,"b72e454885d7c7076efb4288d9d2663b5323a550"
"anaboston","2021-03-14T17:01:29Z",2,2,0,"2a0b7f7a0eadd8f8dfbb9533b4324ad995983827"
"anaboston","2021-03-14T17:01:12Z",4,3,1,"1cf85c5ff344371d2ca3853f66ec686757306c24"
"anaboston","2021-03-14T16:37:34Z",6,2,4,"e6330835b4944a8db55427051f735f2533974889"
"anaboston","2021-03-14T16:36:13Z",6,4,2,"76a05bb1364d6f72c57841ab5679d72d684be321"
"github-classroom[bot]","2021-03-14T16:32:05Z",737,737,0,"5d99dc2e7f00d0aaa0ff6c924e9671ddb873f895"
