"name","date","total","additions","deletions","sha"
"Violetacarrascal","2021-05-28T15:47:20Z",0,0,0,"17c6eaac96921738ec4ebb7f1f37bda73a8b47ad"
"Violetacarrascal","2021-05-28T15:36:35Z",0,0,0,"0f55cf380f59e53a0917f953a81d16a52bfc4853"
"Violetacarrascal","2021-05-28T15:36:22Z",0,0,0,"8e7d4ab47fe4d24087239f47594cac3e7508388f"
"Violetacarrascal","2021-05-28T15:35:45Z",0,0,0,"4321779ea0f418c9bd1c552f918607163651fd04"
"Violetacarrascal","2021-05-28T15:35:27Z",2,2,0,"378bb850b4a0c26b91faa3a5562c6a4b9451c399"
"Violetacarrascal","2021-05-28T15:19:34Z",0,0,0,"34226fce3399d6bdb3733bb058c5e4f724dda7be"
"Violetacarrascal","2021-05-27T08:42:22Z",3,2,1,"4212335fc87aea468b36e0f29216de7ce3b052a5"
"Violetacarrascal","2021-05-27T08:16:42Z",1,1,0,"89e0c98f2d58da7399f4d00012ef33e09c11cdde"
"Violetacarrascal","2021-05-27T08:15:09Z",0,0,0,"d2b1536356414735b3765a3b52abde0c9700e044"
"Violetacarrascal","2021-05-27T08:15:03Z",88,87,1,"a456903609de9b1208803cd83def6e6792129c6a"
"Violetacarrascal","2021-05-26T21:02:15Z",0,0,0,"3540cf8078ffda7f6bc57090879be36b416a34dc"
"Violetacarrascal","2021-05-26T20:48:20Z",0,0,0,"aa263b4ebabdb6ecb6a9d580e9accb4d15931609"
"Violetacarrascal","2021-05-26T20:46:31Z",5,3,2,"bc3e7f28bcccd80bf4f06e43bafb13ea42945ee8"
"Violetacarrascal","2021-05-26T20:34:07Z",3,0,3,"4785f31ca8ae46a7da28f7ac7fdda36051a536dc"
"miguelagueda1","2021-05-22T16:12:21Z",0,0,0,"aa4d2d0b38058576980757f9e0fe9388a582996a"
"Violetacarrascal","2021-05-22T08:41:36Z",6,3,3,"006f2d7e1af440c4c5d42fe9c3c7f5eb6c8d9d9e"
"miguelagueda1","2021-05-21T09:21:28Z",0,0,0,"fe5e83d77023c51f04a820701e8b14c11e1b8c76"
"miguelagueda1","2021-05-21T09:18:02Z",0,0,0,"f6d2f976ab4254ceeb509bf57c62170b4402519f"
"miguelagueda1","2021-05-21T08:24:57Z",0,0,0,"0e71bac619bd7ae90e6dd9298f917ff6f55272a5"
"miguelagueda1","2021-05-21T08:10:19Z",1,1,0,"7d2f94214c2d2e472220056d5c3a5edb772ddd66"
"miguelagueda1","2021-05-21T08:05:28Z",0,0,0,"eda8076cb7ca33221c4c92c7de3df4fd54422419"
"Violetacarrascal","2021-05-20T09:26:58Z",2,1,1,"456b477dc8c7cc45fb5c5eb461b5863a1fd6ffb4"
"miguelagueda1","2021-05-19T09:11:20Z",1,0,1,"3290e32e3bfcae682016f13683e43e97829446eb"
"miguelagueda1","2021-05-19T09:06:20Z",0,0,0,"379e2b0b00a8d92732952eeb04f1b4fd3c7fb540"
"miguelagueda1","2021-05-19T08:55:23Z",1,1,0,"cdf0045d1471e6d54eca2f47bcb8945f3067f406"
"Violetacarrascal","2021-05-17T15:19:38Z",2,1,1,"4784a1a0c55f7a3074a73224fee64b1a84cbb783"
"Violetacarrascal","2021-05-17T15:17:58Z",5,3,2,"d93f1ab274e967585b220f98b474a523f3ebc501"
"Violetacarrascal","2021-05-17T15:01:29Z",26,13,13,"b197f468770c16dcd5f84df4de004bf2b01873ef"
"Violetacarrascal","2021-05-16T17:02:33Z",22,20,2,"3c6d896710e006bdae58a3d12ed8a449c07d943f"
"Violetacarrascal","2021-05-16T13:08:42Z",0,0,0,"e200d5a516180d6bf8a6f587a327d47b8547e907"
"Violetacarrascal","2021-05-16T13:08:27Z",0,0,0,"64132fee83759d83dece34c61922580411412636"
"Violetacarrascal","2021-05-16T13:08:09Z",0,0,0,"f2e41ddc00a9572a277006ad82c4177d24d1811d"
"Violetacarrascal","2021-05-16T12:47:21Z",0,0,0,"bcb4910ae38bcc429957e37e3e8106d2e26fde3a"
"Violetacarrascal","2021-05-16T12:47:02Z",0,0,0,"e095314e3d8f6740d44d4dde520860847f20a1a9"
"Violetacarrascal","2021-05-16T12:43:50Z",0,0,0,"bfa67184ec7a13e9633b28aaf06800e2362edd70"
"Violetacarrascal","2021-05-16T12:43:05Z",0,0,0,"087b6fcdc9aa78ee71b64609be7a056c287dfc15"
"Violetacarrascal","2021-05-16T12:41:57Z",1,1,0,"466ee86e8bd1d24c2bfa6fc420c853ef2ba56a69"
"Violetacarrascal","2021-05-16T12:38:26Z",256,0,256,"d1330fedf46f3ea6301e149ac82967bd723331d1"
"Violetacarrascal","2021-05-16T11:46:41Z",3,2,1,"0bc1ee4baad134f797fc00f2fd58903a3bd056dd"
"Violetacarrascal","2021-05-16T11:37:42Z",306,233,73,"13e56039c22fc2b8791ef5fbddeeb466bc6fe7b2"
"Violetacarrascal","2021-05-15T23:14:49Z",19,19,0,"b80dc121a192ee2c8727bfb3c3135e1b263acb31"
"Violetacarrascal","2021-05-15T22:59:31Z",15,15,0,"c713209eb595a6d97911a321fd3842ad2f149a5e"
"Violetacarrascal","2021-05-15T22:45:34Z",15,15,0,"c8861d6564a6604527275dc92aecfccb3996e05e"
"Violetacarrascal","2021-05-15T22:31:17Z",18,17,1,"e97ad261cc3bb1eb1719a8c824ab4df7a873bbf8"
"Violetacarrascal","2021-05-15T22:13:06Z",1,1,0,"9b9969d7bb191603a7076853e082ffc3c259158c"
"Violetacarrascal","2021-05-15T22:11:10Z",33,20,13,"522be325d705f0362e823067967f80f9b12172b6"
"Violetacarrascal","2021-05-09T17:18:41Z",135,82,53,"0151f8649bbd8eef92489c53bb257a44e647a90c"
"Violetacarrascal","2021-05-03T10:17:23Z",0,0,0,"9bdac0ea2b453ff56a7dafec6e783f546e0a4d0a"
"Violetacarrascal","2021-05-03T10:15:50Z",0,0,0,"e6152f812a5b6e55919da5ea72d59d6f3dac74da"
"Violetacarrascal","2021-05-03T10:13:57Z",31,13,18,"05e91171f79067bc236e2ec4c0eeef2ee0b23030"
"Violetacarrascal","2021-05-03T10:08:09Z",0,0,0,"b304c05f952a166861e691614d26a892cff7ad0a"
"Violetacarrascal","2021-05-03T09:35:07Z",0,0,0,"dc35166635e20b1769f068662d01b97a8731448a"
"Escobar Arenas Jorge","2021-05-02T11:31:22Z",12,6,6,"419077ade0b306b01b6170c4959cc164d4939341"
"Violetacarrascal","2021-05-01T19:35:10Z",20,11,9,"0706fa7f5253499ca099f607e9c52cebb16271a4"
"Violetacarrascal","2021-05-01T18:11:22Z",22,18,4,"df7aa502bb53e15e1c3a3f731169818e2f3ae0de"
"Violetacarrascal","2021-05-01T17:27:27Z",68,27,41,"729cc83a0a1432258dbe42a479d431a8f195f931"
"Violetacarrascal","2021-05-01T17:02:39Z",51,51,0,"18c82166c99f6fd15d99a535f590d1de0ab9f063"
"Escobar Arenas Jorge","2021-04-29T20:25:35Z",55,50,5,"5ddf489c37bc9cf339a8b1851d7d936513a7c38c"
"Escobar Arenas Jorge","2021-04-29T18:51:49Z",4,2,2,"c6df41bdea650dd1fd940d9288fce300572974fa"
"Escobar Arenas Jorge","2021-04-29T18:49:11Z",10,5,5,"2424adcac048fdebc98d82efe9f3a1fe9160ba46"
"Escobar Arenas Jorge","2021-04-28T15:35:57Z",19,14,5,"b188e8aca8799ea3df7ebc948c05b9b4675f836d"
"Escobar Arenas Jorge","2021-04-27T17:50:17Z",128,128,0,"81862726098251641bd8b59acd8f17511da986a8"
"Escobar Arenas Jorge","2021-04-27T17:50:00Z",128,128,0,"2d45fdcd5f9a4994cb70a836d07a69b970b07a5d"
"Escobar Arenas Jorge","2021-04-27T17:00:32Z",0,0,0,"5ed11ed9548c83ebc6ddb83ea6a64b1c80cd99b7"
"Escobar Arenas Jorge","2021-04-27T16:53:37Z",0,0,0,"4332d5f5cf84ee4f703b3bf98d368ae4913b6617"
"Escobar Arenas Jorge","2021-04-27T16:49:26Z",1,1,0,"337eece73c22123297a6fb85e5a6eca4970268a9"
"miguelagueda1","2021-04-25T12:22:15Z",256,256,0,"bf2f5a923abd418d1696bbf42565f1ca845ceb6b"
"Violetacarrascal","2021-04-23T18:39:23Z",2,1,1,"1c13b62030fe980aa66f2c622a21bd0885f9a463"
"Violetacarrascal","2021-04-23T18:37:20Z",4,0,4,"f7f616613a0f08df42ac848bfa6a3e44be0f98e7"
"Violetacarrascal","2021-04-23T18:35:14Z",69,51,18,"a223dc941e3452ec85de5a941b98556764508461"
"Escobar Arenas Jorge","2021-04-21T19:13:50Z",5,5,0,"97b8a8a60d97c5c6e1609c78f9912c44ed6b2f1a"
"Escobar Arenas Jorge","2021-04-21T17:56:39Z",34,17,17,"9889157be2643c38c4c75105411ec3d055e5d2cd"
"Escobar Arenas Jorge","2021-04-21T17:53:05Z",34,17,17,"d267eea917b1a60b932a0a3a89c95df67bc9d144"
"Violetacarrascal","2021-04-21T11:44:53Z",6,4,2,"b31902a4fd0fb6ef1e3e01d854a7666e1306a703"
"Violetacarrascal","2021-04-21T11:44:45Z",40,15,25,"0ba355c065f8231519131a15c7fb90a404b0b0c0"
"Escobar Arenas Jorge","2021-04-21T10:39:56Z",6,4,2,"4f78ebdec85e4f09a6a4085d441c192e50df46e9"
"Escobar Arenas Jorge","2021-04-21T10:39:16Z",6,4,2,"3a675a3331e9895dbf85930a4b00e6f042af0042"
"miguelagueda1","2021-04-15T21:35:26Z",46,37,9,"07abdbb62aa6c08a9b15ecbd189ad9377a503750"
"miguelagueda1","2021-04-15T21:05:58Z",11,6,5,"b03ca0a424418e3ac2c184484295a2d29bb3a621"
"Escobar Arenas Jorge","2021-04-10T15:30:07Z",2,1,1,"6fd3a5279408d7098769158c9741c4cdba1b3ac4"
"Escobar Arenas Jorge","2021-04-10T15:29:44Z",2,1,1,"b1fcc002ad29f38c06172139e06eea1ef7c4721b"
"Escobar Arenas Jorge","2021-04-07T10:09:53Z",4,2,2,"0b4824463ea873c728bcfef77d9e00ebb858eee4"
"Violetacarrascal","2021-03-21T16:43:26Z",59,59,0,"9804d9ce356c320e4336e046db874bedd144938b"
"Escobar Arenas Jorge","2021-03-21T15:44:24Z",12,8,4,"8537b37964b55988ddd060379976a205867d5f56"
"github-classroom[bot]","2021-03-21T15:37:01Z",737,737,0,"54a4e526297f1ddade09f194084397cdcc2df2d2"
