"name","date","total","additions","deletions","sha"
"Marco Antonio Pinto Tapia","2021-05-28T22:23:57Z",0,0,0,"9240e586f831e57ec4265dc9b130b006aaa66d86"
"Marpiki11","2021-05-28T22:04:43Z",144,72,72,"f8b2c0d90c5c89a4a0bd14c492e2557257112613"
"Marco Antonio Pinto Tapia","2021-05-28T21:52:44Z",1096,0,1096,"29d4b09121625f4c6393fda79c8dc6b833ea3071"
"Marco Antonio Pinto Tapia","2021-05-28T21:47:13Z",191,30,161,"dca828ab329e2a99e6f7d7f3f8725251168b9e08"
"Marco Antonio Pinto Tapia","2021-05-28T21:39:44Z",16,8,8,"8530aef569ad0dec74a4916cc76da57cb444005e"
"Marco Antonio Pinto Tapia","2021-05-28T21:38:04Z",18,4,14,"921683b9279f58c2a2be93942490e917dbf63919"
"Marco Antonio Pinto Tapia","2021-05-28T21:25:40Z",460,123,337,"a0ecc492e77fa6e19ec2bcfbf3d17950a9168a6e"
"Marco Antonio Pinto Tapia","2021-05-28T20:38:44Z",52,23,29,"caa508361be14dab861276073c0b0db47eae5744"
"Marco Antonio Pinto Tapia","2021-05-28T20:02:19Z",64,29,35,"6c7c0f350e38038851ad312f90dad25c1e9e418a"
"Marco Antonio Pinto Tapia","2021-05-28T19:26:12Z",0,0,0,"f838a6ff903467028b55f903540e512ed3047cea"
"Marco Antonio Pinto Tapia","2021-05-28T19:24:55Z",0,0,0,"e6f7ea56557088dd69fdb3293cb1df15b13f7ac0"
"Marpiki11","2021-05-28T19:12:24Z",4,2,2,"ffb2b5678842970ea15a964dd968165b4b073384"
"Marco Antonio Pinto Tapia","2021-05-28T18:38:58Z",244,216,28,"2fbb19d6ea115413a5b4499adf3c1a83d4b9bb4b"
"Marco Antonio Pinto Tapia","2021-05-28T17:19:56Z",338,146,192,"bb13c1ea4e76201d1b64924520dad5c9c6dd74dc"
"Marco Antonio Pinto Tapia","2021-05-28T17:00:21Z",112,109,3,"09b163309b8ea0dac32de836eb7618c0107fa6a2"
"Marpiki11","2021-05-26T09:45:32Z",2,1,1,"4cec83dbf6433629eda9c3000e840a58bb2a30ae"
"Marpiki11","2021-05-26T09:38:34Z",29,15,14,"7499c54a87cf6223082ab03c362712dd46011e9b"
"Marpiki11","2021-05-26T09:38:30Z",71,11,60,"5b4cec4ab0977b631c7face42566e287aa42b1fd"
"Alejandro-Montero-Porras","2021-05-26T09:03:11Z",8,5,3,"60a826d8d34aceedf778696a6751b2c781ebd35b"
"Alejandro-Montero-Porras","2021-05-26T08:55:30Z",25,12,13,"4449f970e7d746535d19e8b47d4bb881c1729418"
"Alejandro-Montero-Porras","2021-05-26T08:47:44Z",8,5,3,"536cfee9e8bbf11847ebc55d940d14429d0e7000"
"Alejandro-Montero-Porras","2021-05-26T08:39:51Z",8,0,8,"785df1d8d36c6dcd28b20fff66a68c24622b03ec"
"Alejandro-Montero-Porras","2021-05-26T08:37:17Z",2,1,1,"7832edb1f0faad468172a63f4db641b973bbcaea"
"Alejandro-Montero-Porras","2021-05-26T08:34:54Z",6,4,2,"c30e05700464b548c80c7997e522f046e0268b4e"
"Marco Antonio Pinto Tapia","2021-05-21T09:06:47Z",1108,707,401,"09b1e79206ccf5d1f15ba3063c07dc9ff8b05831"
"Alejandro-Montero-Porras","2021-05-20T16:30:56Z",0,0,0,"98e1f68dc81037d2b6d380ae3afece480c8af03c"
"Alejandro-Montero-Porras","2021-05-20T16:29:59Z",0,0,0,"db8839d8cbc8cfa2a85172f911288a005e0b7458"
"Marco Antonio Pinto Tapia","2021-05-18T17:48:12Z",598,312,286,"0f793a2909672ab581914125a375bda14e45b400"
"Marco Antonio Pinto Tapia","2021-05-18T11:18:23Z",2,1,1,"990685d1942d6e333ba4c23c4b3ae04c71382410"
"Marco Antonio Pinto Tapia","2021-05-18T11:17:37Z",267,220,47,"2ccbb1345c7075466c0151270bd67581468a0cd2"
"Marco Antonio Pinto Tapia","2021-05-17T18:54:04Z",338,283,55,"c97cc5a1e22496e9e0a14b84836ddd27fd1ad451"
"Marpiki11","2021-05-14T11:23:37Z",38,30,8,"b2a404d6e2889d46f8de095ee06ebfb34ccec7fe"
"Marco Antonio Pinto Tapia","2021-05-14T10:37:50Z",2,1,1,"f68919909b230e906901355c2be38eaa9abf81bb"
"Marco Antonio Pinto Tapia","2021-05-14T10:23:26Z",295,142,153,"8d40b64dfda90100d04dadd9a371e784de5ddfbf"
"Marco Antonio Pinto Tapia","2021-05-14T09:06:57Z",683,339,344,"81e8486e6a411ef395f81234b89a367dc32b7a4a"
"Marco Antonio Pinto Tapia","2021-05-13T23:22:56Z",51,0,51,"48b70cf76857ed50dc80a27181e9b16d3b1a5a38"
"Marpiki11","2021-05-13T21:52:11Z",302,151,151,"c64d7581a3d495f0770ba70fd0ac7db657b40edd"
"Marpiki11","2021-05-13T21:52:09Z",102,91,11,"ede010c866a1198ee9a026dafd04c810746ce337"
"Alejandro-Montero-Porras","2021-05-13T15:52:01Z",302,151,151,"f12ee4a69a418c2c170da7489bbb232287098b7d"
"Alejandro-Montero-Porras","2021-05-13T15:40:35Z",451,450,1,"807cc760c3f3981d6f536a0bf76997c9010bb1f5"
"Marpiki11","2021-05-10T01:21:24Z",66,52,14,"84cd74f267e5b1bc07fd498920d9fd7314a1ed5b"
"Marco Antonio Pinto Tapia","2021-05-09T23:40:46Z",96,67,29,"2baf5be6870dfed5228de5352724983694bedcd2"
"Marco Antonio Pinto Tapia","2021-05-09T20:12:55Z",144,120,24,"c2ebcc785d26786926cc4eefcacf56ce64b9d5f5"
"Marco Antonio Pinto Tapia","2021-05-09T17:53:41Z",280,177,103,"6c3ededa08bcfa0db2752b05a9f2ff8273676ece"
"Marco Antonio Pinto Tapia","2021-05-09T17:53:39Z",101,49,52,"d87021ab37291220fcba3240321ab5099c70d957"
"Alejandro-Montero-Porras","2021-05-09T10:42:02Z",136,105,31,"08944153b4d125cacbe7869d22168c6749d17922"
"Alejandro-Montero-Porras","2021-05-08T17:45:41Z",154,77,77,"7989c30e0533092bb6550fb69a107eeff15e6b4a"
"Marco Antonio Pinto Tapia","2021-05-08T16:33:37Z",16,9,7,"2222c26c7fb9521ee86f9a66867dc0996034ad01"
"Marco Antonio Pinto Tapia","2021-05-08T16:06:58Z",14,7,7,"2757027ffb768661fb101a962d28e25bcf202793"
"Marco Antonio Pinto Tapia","2021-05-03T19:51:10Z",110,69,41,"a4f8992ce1418ac557e7f6c255b8d7edcf59244e"
"Marco Antonio Pinto Tapia","2021-05-03T19:32:17Z",93,73,20,"21a53fd36590a34d5942297b655c1e22429adf55"
"Marco Antonio Pinto Tapia","2021-05-02T23:10:56Z",95,66,29,"c97cbe8595eeca0f7a4a2f8c167274e3e3965de7"
"Marco Antonio Pinto Tapia","2021-05-02T22:21:08Z",169,70,99,"cd439f1d918a51cb95e704fd3675f80818524a75"
"Marco Antonio Pinto Tapia","2021-04-29T09:43:23Z",76,56,20,"c2457fe526549d935b750ef96a752b222a8df9eb"
"Marco Antonio Pinto Tapia","2021-04-28T01:04:48Z",483,275,208,"049f774f8176aab1ca5436c0d2a7bf64db8aedef"
"Marco Antonio Pinto Tapia","2021-04-27T19:08:15Z",21,16,5,"46c41a671be8790c25cd452aa098500beec348dd"
"Marpiki11","2021-04-26T20:25:12Z",7,4,3,"7b548fb561eeebce722486dcc72948524aed11ee"
"Marco Antonio Pinto Tapia","2021-04-26T19:58:07Z",31,13,18,"0e3d3ec1b12ac543e333cb43a3741843a09dfdd6"
"Marco Antonio Pinto Tapia","2021-04-26T19:20:29Z",0,0,0,"75089881c235ecc8ef07f591354ebbe5be78fd63"
"Marco Antonio Pinto Tapia","2021-04-26T19:17:24Z",408,217,191,"204abbca6e615b6bc085dbfe829e1b726186683a"
"Alejandro-Montero-Porras","2021-04-26T18:45:54Z",28,28,0,"04ae68a44902e8bc843eab0e969e8a65c051981e"
"Alejandro-Montero-Porras","2021-04-26T17:39:48Z",4,3,1,"4e73af06a8e15c5529a0eb53f02a0f97d6d06100"
"Alejandro-Montero-Porras","2021-04-25T17:41:56Z",383,194,189,"4aebaf0543bc73a7ef1dd6496d69e4bdc79f35f3"
"Marpiki11","2021-04-25T17:41:01Z",54,54,0,"27b9b247793956bef6203691bd8cccf1a01096be"
"Alejandro-Montero-Porras","2021-04-25T16:39:48Z",1,1,0,"8d8e42c1c1343f0321c008bc3394b177d97d80f2"
"Alejandro-Montero-Porras","2021-04-25T16:39:43Z",182,147,35,"b633966fb6a88efd53fb42367a3e02b9423b099f"
"Marco Gaspar","2021-04-25T15:29:49Z",1,0,1,"43790ec8fe7a20574856be811833e79b96af777e"
"Marpiki11","2021-04-25T15:20:20Z",1,1,0,"90da42cb3d18680161617db2de79dba968ba028e"
"Marco Gaspar","2021-04-25T15:18:54Z",1,1,0,"ee68523cc25bf299f9adf645cf3685a1277ae2cc"
"Marco Gaspar","2021-04-25T15:18:32Z",1,0,1,"6f6c7a7a96a77927d1ae426a7ff6f8ff53218e85"
"Marco Gaspar","2021-04-25T15:17:55Z",1,1,0,"6f3332f877d5e58f980d5fab7157e02c72918f8b"
"Marco Gaspar","2021-04-25T15:17:33Z",1,0,1,"8817beb0b08e631d18426432ffa09c1878d4c273"
"Marco Gaspar","2021-04-25T15:15:19Z",1,1,0,"4b8aae41e33139b8c1976431a10b4c2bf0e76163"
"Marco Gaspar","2021-04-25T15:14:17Z",1,0,1,"f54d0222e2597ebecc9a2a26840e9c1e9621bf2c"
"Marco Gaspar","2021-04-25T15:11:50Z",1,1,0,"43f8ed0b667b2b0c2a471617986c2b81c854d788"
"Alejandro-Montero-Porras","2021-04-24T21:06:06Z",6,3,3,"eab9fa78d3dcafd25cb9c793e14849e177621b7a"
"Alejandro-Montero-Porras","2021-04-24T18:18:17Z",43,43,0,"fae706948a89e1ea9f66f119f0f36a9d23a83e45"
"Alejandro-Montero-Porras","2021-04-24T18:03:18Z",60,26,34,"a627169a1dda4df51bbec82f929c1e5a86e253f6"
"Alejandro-Montero-Porras","2021-04-24T17:34:23Z",69,69,0,"bfcd834202ea0e25c0c3c93a7eec69f235d386fb"
"Marco Antonio Pinto Tapia","2021-04-24T17:12:28Z",89,45,44,"4d238403798564cd142c4cb984823cabfa869599"
"Alejandro-Montero-Porras","2021-04-24T17:06:41Z",43,43,0,"36b76478d2c9dbf7d2191670171444fd2ab767cd"
"Alejandro-Montero-Porras","2021-04-24T16:42:44Z",50,50,0,"5c0de9650255147308aa8902cd7f9bd0e7045e75"
"Marco Antonio Pinto Tapia","2021-04-20T08:15:34Z",122,121,1,"12d6f6e17087aa37f9528d715a3eb36d13c9c174"
"Marco Antonio Pinto Tapia","2021-04-20T08:11:49Z",1,1,0,"daa26b7af6a239da981028ebb96f7f04feda7e0e"
"Marco Antonio Pinto Tapia","2021-04-09T09:14:58Z",6,3,3,"d3a0732c9e14f0113918dff8f6b9d68e5f8bf599"
"Marco Antonio Pinto Tapia","2021-04-05T20:03:02Z",101,52,49,"27a2e7f505ecfe7ab917d17d325f9cfae8d9c608"
"Marco Antonio Pinto Tapia","2021-04-02T17:18:32Z",5,0,5,"a4b1a679d4b98300c9160b45a8fc608427d8110c"
"Marco Antonio Pinto Tapia","2021-04-02T16:56:18Z",0,0,0,"bb729e0adb4322884f07d54f46cb09cc4309c3f2"
"Marco Antonio Pinto Tapia","2021-04-02T16:56:11Z",39,15,24,"4c1c966d7fad61b0013380af6b2f9641f7aa485e"
"Alejandro-Montero-Porras","2021-04-02T16:20:11Z",1,1,0,"bf10cd36bc8054a7ce8019517f89ff3581c6e9fa"
"Alejandro-Montero-Porras","2021-04-02T16:09:35Z",1,0,1,"ae734fc6a4397d7b002c8fb19ad2d74b8ab2f6ae"
"Alejandro-Montero-Porras","2021-04-02T15:55:42Z",164,160,4,"25797d28352152f5da098ad0f534f78973d2463f"
"Alejandro-Montero-Porras","2021-04-02T15:55:33Z",162,1,161,"31b2380fc477da7be48a2e504f37d799b8f52579"
"Alejandro-Montero-Porras","2021-04-02T15:48:37Z",162,161,1,"941230d911f10af6af1559f1054a6721a55f1781"
"Marco Antonio Pinto Tapia","2021-04-02T15:37:45Z",164,160,4,"8b3e5a2cf6852e6e7f6ba93c754d64c755550e34"
"Marpiki11","2021-04-01T17:08:57Z",3,3,0,"c622b166befafcdaadfeaf4745480139b64bd11c"
"Marpiki11","2021-04-01T17:04:52Z",5,5,0,"e29bf5ba3e7aaaf8a3a6f2d7f4644a380862230d"
"Alejandro-Montero-Porras","2021-04-01T17:02:27Z",5,5,0,"2188f0dcf96d656b5409b8bb8d66e8d9c1f9501f"
"Marco Antonio Pinto Tapia","2021-04-01T16:56:34Z",1,1,0,"94910e3d4ddedbd512941583446e5119d4378623"
"Alejandro-Montero-Porras","2021-04-01T16:55:14Z",5,0,5,"662a77f358397719bc8bfc5d4df49f5d2f9a9ec1"
"Alejandro-Montero-Porras","2021-04-01T16:48:42Z",6,5,1,"f61ca84efe0ab6c1c10bc23c2f9f9df01438618b"
"Marco Antonio Pinto Tapia","2021-04-01T16:40:25Z",1,1,0,"485e39fad472a3cffd2a35a30b78e491bbd8ba0d"
"Alejandro-Montero-Porras","2021-04-01T16:32:05Z",0,0,0,"2814f23ea513393150faf355777ac38a14f3f58a"
"Marco Antonio Pinto Tapia","2021-03-12T21:35:16Z",6,3,3,"87ba4c8ab2fbbca893586d58f184986b4cccbf0e"
"Marco Antonio Pinto Tapia","2021-03-12T21:30:07Z",4,2,2,"98f3dc663deefd55c0bb6fbddb44f948d19f6a89"
"Marco Antonio Pinto Tapia","2021-03-12T21:28:30Z",2,1,1,"48cd865098551a18dbf4f6e9a8caaadb2fbdfbcb"
"Marco Antonio Pinto Tapia","2021-03-12T13:11:30Z",4,3,1,"f6b94eba2481fef712ca9b542c8a0bc543297dbb"
"Marco Antonio Pinto Tapia","2021-03-12T13:07:09Z",2,2,0,"805490acc77e490393820655a6f2d83f4b1a2165"
"Marco Antonio Pinto Tapia","2021-03-12T13:06:46Z",6,3,3,"e893253af1d9b849fd9685f42762b37c98bbc62e"
"Marco Antonio Pinto Tapia","2021-03-12T13:06:09Z",6,3,3,"a8dee3feeb84898a0f4145f2280a252daf3d72e0"
"Marco Antonio Pinto Tapia","2021-03-12T13:04:37Z",4,2,2,"79ad84fb47194254fa75ad4af4a9f995770c557d"
"Marco Antonio Pinto Tapia","2021-03-12T12:42:36Z",5,0,5,"fe751abf7a71383ff70e7f38d94cc905fd0d787a"
"Marco Antonio Pinto Tapia","2021-03-03T21:23:46Z",2,1,1,"af26d58818de3d79028018c31795d0837399bfd0"
"Marco Antonio Pinto Tapia","2021-03-03T21:22:54Z",2,1,1,"7d1d5266571101132b8bd05cc2ae31be2bf2e850"
"Marco Antonio Pinto Tapia","2021-03-03T21:21:05Z",15,11,4,"e8c21dbae1c20bc8104bd1380799de7f0876026c"
"Marco Antonio Pinto Tapia","2021-03-03T20:39:50Z",2,1,1,"428a0a9c3595efc1afd3c1a54f938dd05103f362"
"Marco Antonio Pinto Tapia","2021-03-03T20:39:04Z",2,1,1,"4524516d0da5e0d3132ac2182f6a89aa7540fdc5"
"Marco Antonio Pinto Tapia","2021-03-03T20:38:30Z",2,1,1,"6cf06fc074bdd2d2444e3f88e82011132a09ff5e"
"Marco Antonio Pinto Tapia","2021-03-03T20:36:19Z",6,6,0,"c7e2e65b3ebe092a70bd9b4ce2c557d75519c2f0"
"Marco Gaspar","2021-03-03T17:18:03Z",1,1,0,"07ed51e7d40583b7afb9121406a47a3c57547d1d"
"Marco Antonio Pinto Tapia","2021-03-03T16:38:40Z",2,1,1,"5960deb27acf4afad9c6935e66370e09f319c9f1"
"Alejandro-Montero-Porras","2021-03-03T16:19:07Z",8,4,4,"44d59781bdb075e45b91cbef661aacdb3d09e991"
"github-classroom[bot]","2021-03-03T16:04:31Z",737,737,0,"2c6aadb00315466e56beb878178c55902a24338c"
