"name","date","total","additions","deletions","sha"
"Garrudo-404","2021-05-29T12:21:41Z",0,0,0,"8efeb734f60722592eb5794a669be1274bdac2aa"
"Garrudo-404","2021-05-28T17:24:23Z",0,0,0,"bcf51d0091ea77263645829f26b598fd33289620"
"Garrudo-404","2021-05-28T17:22:41Z",41,18,23,"760aa7c64750014115323f1f038197aa04b7b225"
"Garrudo-404","2021-05-28T17:22:11Z",0,0,0,"93969397c7e84c99f77dc3f54876fca489bc27e6"
"Ikercasti","2021-05-28T17:21:22Z",41,18,23,"32a840188f95645d792294830c7e459e5589475a"
"Garrudo-404","2021-05-28T16:56:06Z",0,0,0,"7a99ceafca86864a4ebccfbd8ed1cc6e2e9cfbd2"
"Garrudo-404","2021-05-28T11:23:37Z",30,0,30,"8745d5083543458b990f2b25430727f71a30e141"
"Pigamer37","2021-05-25T17:22:45Z",7,4,3,"732f661275eefcfb286146508785957b32f60a87"
"Pigamer37","2021-05-25T17:22:40Z",13,7,6,"9634f105b34141162bec731301b5a8feeb6b67f6"
"Pigamer37","2021-05-25T16:46:38Z",13,2,11,"076749581351fbe69ca71f297c1e8cbba1cf6334"
"Pigamer37","2021-05-25T16:46:23Z",5,3,2,"5a26e7a7dd506fde4babe269c129f907a06b40cb"
"Pigamer37","2021-05-25T16:38:29Z",44,4,40,"36e70cffd8717f4577e18d4a416b1484993fdd6a"
"Pigamer37","2021-05-25T16:30:12Z",56,56,0,"2774e5cc3b7f38a5d9c4690051e6a44fb86c9fc3"
"Garrudo-404","2021-05-21T15:28:20Z",39,18,21,"4f9d46f7d3a7a6562b14541cde7c3017517e85a0"
"Garrudo-404","2021-05-19T12:08:17Z",0,0,0,"378f18982d111b0680b3a10db518eaa3b76713b4"
"Garrudo-404","2021-05-19T12:07:15Z",0,0,0,"97022be4ca950f641636ca2dbced90503ab3a92b"
"Pigamer37","2021-05-18T19:11:17Z",11,5,6,"5bb8f358f840c2d5a857079a1511d35c428420c7"
"Ikercasti","2021-05-16T19:33:12Z",160,139,21,"feb9920deffa49d35cde07ebe6920dc4e9f375b5"
"Pigamer37","2021-05-16T19:21:12Z",48,20,28,"bd7c8a2e3dd5aceb04be984fab7800ac289d251b"
"Pigamer37","2021-05-16T17:35:10Z",48,40,8,"276ceb43532a8a8039e580dec0eb0384baf6e9be"
"Pigamer37","2021-05-16T12:59:24Z",55,52,3,"7b70e1e7ca08f7b9bf925b413f8842c7c8b2ae43"
"Pigamer37","2021-05-16T12:03:55Z",73,59,14,"5c5b6ccb694c8fbce7b885ea8343c9cb432143ff"
"Lucas-Go-Vel","2021-05-10T18:55:36Z",98,42,56,"ca5bae7d7cc89b2a55a649a69952f3b4cb2f704c"
"Pigamer37","2021-05-06T12:54:34Z",24,12,12,"447581280b6d9ff8cb4bd775e24b9126818c509b"
"Pigamer37","2021-05-06T12:22:12Z",50,22,28,"0a5bd7111aa96c6294f36282d1f7c77e8c6c2e09"
"Pigamer37","2021-05-05T19:48:46Z",36,14,22,"43df5523115c288e228e84d1ccac136cf76cf64c"
"daniel-fuertes","2021-05-01T11:54:33Z",54,54,0,"41c5d738d4ff7a41c53a2088b8da5225ed62f3c3"
"Garrudo-404","2021-04-29T21:34:15Z",515,515,0,"d4fef7e77f94edbce3e43018173b19753875ce52"
"Garrudo-404","2021-04-29T21:34:04Z",515,0,515,"6d18818b9226f90999cf5169c491c5bf4c74eaef"
"Garrudo-404","2021-04-29T21:18:44Z",515,515,0,"d48a2c5167200c5cd7fb1f9cfb4a66b858c6e4b7"
"Pigamer37","2021-04-28T21:38:31Z",5,3,2,"aa7d6befcd390aa3625a2aeae50dc61b8cb5cbe1"
"Lucas-Go-Vel","2021-04-27T20:23:07Z",12,6,6,"5ee7797b9443c0b37ac8bc4dc33c8f1f43a5794f"
"Lucas-Go-Vel","2021-04-27T20:18:52Z",29,29,0,"52977a6fdfa3816046689f769d6753b3f2d0c15c"
"Pigamer37","2021-04-15T21:46:57Z",0,0,0,"4b59c68d8cc1bdee36956633f60cd92cd13fdf99"
"Crisboned","2021-03-30T19:11:45Z",0,0,0,"a9766943f565c60e4dcae45844ff1a32c68a9ff9"
"Pigamer37","2021-03-29T14:54:59Z",4,2,2,"d2478350d1bbb5ce9fe6fd1b3d9e8077c99115b5"
"Pigamer37","2021-03-16T16:59:05Z",1,1,0,"cc7067af4b442791b6f842305c18b8699636cae5"
"Pigamer37","2021-03-16T16:57:56Z",7,0,7,"25661852a8a7afdd8243706c8db3303aa220740e"
"Crisboned","2021-03-16T16:55:53Z",0,0,0,"cefc85af8ec538a4e103cafea16e012d261809f7"
"Crisboned","2021-03-16T16:55:20Z",8,6,2,"5054819b5a1d227e1e0859de2e0f1f1804b56c2e"
"Pigamer37","2021-03-16T16:48:26Z",14,0,14,"c34286d66fad905c04c64a20125069a9042cd29f"
"Pigamer37","2021-03-16T16:42:13Z",15,15,0,"0a936d20ddafdf46f53809f70920154eb084f82e"
"Garrudo-404","2021-03-16T16:42:12Z",1,1,0,"8306ceb24b4d9592bdbca6d92102f6b897c04a53"
"Pigamer37","2021-03-16T16:41:57Z",4,4,0,"bc8c10258ff33105c08e6d28f4378c88c7624392"
"Pigamer37","2021-03-16T16:40:04Z",31,31,0,"28a0e999dfa102304f63afb08093664d20ceb7d5"
"Pigamer37","2021-03-16T16:39:34Z",31,31,0,"f8393c87927637d1059c6680da4625cc0c3bf4ed"
"Garrudo-404","2021-03-16T16:38:45Z",1,1,0,"aaef1de9e7d5241d1deb2df06e583e02ec26de4d"
"Crisboned","2021-03-16T16:38:09Z",2,1,1,"6b1789728b7242ae4d853d246d0cdd21f25d2e4e"
"Garrudo-404","2021-03-16T16:37:41Z",14,14,0,"b3d6ace464e73f761d055cef90c29362f5afa4f2"
"Crisboned","2021-03-16T16:36:05Z",2,2,0,"50aa5beebe185db42d996dfc1a206f77e2a7fba2"
"daniel-fuertes","2021-03-16T16:35:51Z",2,1,1,"d795ef1d64939906f624a18c43edf71c01785c4d"
"daniel-fuertes","2021-03-16T16:32:49Z",1,1,0,"7093029e77c2c2bf05aec5f35e7557fdebc4dff1"
"Pigamer37","2021-03-16T16:29:31Z",3,0,3,"8aab8ff2dd531b8673ef657f0dd14769f78b195f"
"Pigamer37","2021-03-16T16:28:31Z",3,3,0,"0a28fc30735f28f43e297a2af0d60c33d6cb8cdc"
"Ikercasti","2021-03-16T16:24:43Z",3,2,1,"ea1029ca9b5bba6c1edc921e9f4437622a2fa5bc"
"Lucas-Go-Vel","2021-03-16T16:22:36Z",2,1,1,"ea5e28da650868ee99661985185d538e8022a6b6"
"Pigamer37","2021-03-16T16:21:29Z",2,1,1,"d286cfdf824eae4ca5ce4edc9036dd52c7468347"
"Pigamer37","2021-03-16T16:17:04Z",1,1,0,"2e0b868853dd1279f008ab39947903bcc3092987"
"github-classroom[bot]","2021-03-16T15:56:44Z",737,737,0,"b43b446d2848840f93043de14a4a02958e7c5163"
