"name","date","total","additions","deletions","sha"
"adrianlan79","2021-05-28T14:05:07Z",17,13,4,"8f18d4d5e80540c71e129fcf064fbf89270ebf43"
"ruben1000iq","2021-05-28T12:22:49Z",2,1,1,"460a068c3623822e07ce9a37c4838ffee726e1bf"
"Constan-14","2021-05-28T12:15:16Z",4,2,2,"f71c6a4c8d4e86c0ae67b5afe15a96bf69d00cb9"
"ruben1000iq","2021-05-28T12:08:21Z",430,215,215,"5215476e55922eecf402b4b7619f6aa665605dce"
"adrianlan79","2021-05-28T11:22:31Z",0,0,0,"e21cf04dc4b724f4ce771d12626f45c8f920aeb5"
"adrianlan79","2021-05-28T11:22:27Z",6,3,3,"81a0847f61c6792ae1d1dca031b98f61fcc7368b"
"adrianlan79","2021-05-28T11:22:21Z",0,0,0,"b0e589a5f6364203147b634ffe5aa0f9ad81426f"
"adrianlan79","2021-05-28T11:22:17Z",0,0,0,"316f81ed72775e41a10e9e8c2a09ddb8679caeba"
"Constan-14","2021-05-28T10:17:43Z",0,0,0,"3eacf2665afa3b0c339159f480e999bc60a9e2ed"
"Constan-14","2021-05-28T10:17:41Z",0,0,0,"29364a5475b6d5e7dc8f3ade59862524d5f803d6"
"Constan-14","2021-05-28T10:17:39Z",0,0,0,"a8ae00d9c620ccddc2d024a8ea54dfc259ef5a5b"
"Constan-14","2021-05-28T10:17:35Z",0,0,0,"92437e1819c6a58b00d17926fb42373b063719aa"
"Constan-14","2021-05-28T10:16:35Z",0,0,0,"c1465e5e04947e1e59cf93d1cfd8bd39e8b01ff8"
"Constan-14","2021-05-28T10:16:32Z",0,0,0,"97d628d08de2e343e7775ac5b82fdcbdf636633f"
"adrianlan79","2021-05-27T22:05:15Z",676,351,325,"38dd1716a23c243e70befab2e7c0124dcca5ffbf"
"adrianlan79","2021-05-27T22:05:00Z",20,10,10,"5a819b1b8f656ef2837eb5dfca813bfdabe2b346"
"Constan-14","2021-05-27T10:36:07Z",413,94,319,"370724de7f5521b0f51f79d89c362818640ee402"
"Constan-14","2021-05-27T10:36:04Z",253,253,0,"1ce602a8de834d73ef65d8b3617ac158f42ddacf"
"Constan-14","2021-05-27T10:23:45Z",2,2,0,"b16b545a5fe4cde8c692ab660bf829d37f8c1781"
"Constan-14","2021-05-27T10:23:35Z",10,4,6,"7e351b0903893a37a18e208c84c2920e95f4ba9b"
"adrianlan79","2021-05-26T12:27:45Z",50,15,35,"9406855fa3a94d5408922732f0863c98eb2d6ab3"
"adrianlan79","2021-05-26T12:27:42Z",2,2,0,"fcb4e102c6a49fe5ff42a6ae4e3cf52bd5bbcdcf"
"Constan-14","2021-05-26T11:34:32Z",0,0,0,"1062d0da3724d22f37bb1da7a15706ed3e4472e1"
"Constan-14","2021-05-26T11:34:29Z",0,0,0,"153820ce5cb90352ce08d7705551cc02145ceadf"
"Constan-14","2021-05-25T18:33:29Z",2,1,1,"278af289b6d48b58475342f6ba1e019155c0e5c2"
"Constan-14","2021-05-25T18:33:01Z",48,14,34,"015fea06cbc30ea94014aa0a3740090bd46a9700"
"Constan-14","2021-05-25T12:28:24Z",11,7,4,"5dfda066fd0fc20091b234c6c47de69533f09042"
"Constan-14","2021-05-25T12:28:22Z",44,17,27,"f7703009e901dc1587cc33cad2264be5d5e63753"
"adrianlan79","2021-05-25T12:18:11Z",11,7,4,"062d88cb2829b1712884691150755680bf2ce1b9"
"Constan-14","2021-05-25T11:41:41Z",0,0,0,"271a490f7bd5fef0cd50b8eedee91b39b9849877"
"Constan-14","2021-05-25T11:37:52Z",0,0,0,"4d7c38b4b8ed358a89e39d1b1183da12039fd442"
"Constan-14","2021-05-25T11:37:49Z",0,0,0,"a3e0b8d24ee6bce21a7b4b06f14cb8ab52c2b248"
"Constan-14","2021-05-25T11:37:44Z",0,0,0,"72898e96fbd3cb437dce9594ff0fe09d82c4735b"
"Constan-14","2021-05-25T11:36:18Z",0,0,0,"cdd4a0bc9c3435588e80addd60a64330e8c55f23"
"Constan-14","2021-05-25T11:36:14Z",0,0,0,"1b2119648fe184327ffbeb34199616c6de200d3c"
"Constan-14","2021-05-25T11:36:08Z",0,0,0,"0053b98cbe76df8749990675796b8dc9a9db5494"
"Constan-14","2021-05-25T11:36:06Z",0,0,0,"5b65d681f009bb33b606e00e36af7a36a5941150"
"Constan-14","2021-05-25T11:36:04Z",0,0,0,"c4c0ff28d30edb1d2190ab623a2f60b0a196f9f1"
"Constan-14","2021-05-25T11:35:47Z",0,0,0,"de89d061a2d9655c639ec6a970dc03198feff91b"
"Constan-14","2021-05-25T11:34:48Z",0,0,0,"37ff97c84b79efb871082aa905b038ff1fdf1b14"
"Constan-14","2021-05-25T11:34:45Z",0,0,0,"5972c1e771b151fab5cf69c3ba09339f17eadcd5"
"Constan-14","2021-05-25T11:34:42Z",0,0,0,"336ebc0b986db00cb3bf7b0ef8ee147110bd5cce"
"Constan-14","2021-05-25T11:33:26Z",0,0,0,"7b86225c7e9b98852d15b76b530a01c7f4144cf1"
"Constan-14","2021-05-25T11:29:26Z",0,0,0,"a2ab8dff95b4213e6ca72d2069eac3958a02474f"
"Constan-14","2021-05-25T11:26:29Z",0,0,0,"3b8ddc1f622f4249683f541389b74f7169675150"
"Constan-14","2021-05-25T11:26:18Z",90,46,44,"44123629e9e25d54f2b5fb92efa870bf47df10dc"
"adrianlan79","2021-05-25T10:41:57Z",2,1,1,"6d79530d0f1497f19305847c203e58cca6533c66"
"adrianlan79","2021-05-24T17:34:31Z",6,3,3,"0eda92975b3bc77c61ce82385d245df5c268b435"
"adrianlan79","2021-05-24T17:34:18Z",18,9,9,"4af74c510979a72d57e734daa98cc5fed30d39fc"
"Constan-14","2021-05-24T17:30:54Z",6,3,3,"dd73585d2f9a29ec3468bf9042e32e7497b98344"
"Constan-14","2021-05-24T17:13:46Z",4,2,2,"a20753527def88680b914f72890a8f22ccdc3532"
"ruben1000iq","2021-05-24T17:11:40Z",144,122,22,"292483441abf925b15f2b0ee60c06d15c1cb121b"
"Constan-14","2021-05-24T16:48:49Z",43,23,20,"e4e6936b8e841260caf1b8a06a4086cb7c75315e"
"Constan-14","2021-05-24T16:04:27Z",20,12,8,"ff08fbf2900dbb3a0e65df573de187e209f3afce"
"Constan-14","2021-05-21T10:05:55Z",29,27,2,"d379bf63dddc782a93d6ee4d92a28a995bdfa491"
"Constan-14","2021-05-21T10:05:17Z",204,100,104,"58459bb9594e6bf11dc30ad7a5ce7847c39bd4bf"
"adrianlan79","2021-05-21T09:23:50Z",24,15,9,"0c4f72b7c6e187c6fe9900a368b768565bbda2d4"
"adrianlan79","2021-05-21T09:23:38Z",30,27,3,"03e8e1b6fd3efd4ceb697465fe262bc032ca97f6"
"Constan-14","2021-05-21T09:15:52Z",24,15,9,"d663673731891d62c967671c8f1d9aee57738ca3"
"adrianlan79","2021-05-21T09:03:41Z",133,73,60,"0f70165d748e29eca8f61b490c30adfa667e6a02"
"adrianlan79","2021-05-21T09:03:39Z",50,50,0,"b486a48343a32b6645ff878e509a72e1cafa81c7"
"Constan-14","2021-05-21T09:03:02Z",133,73,60,"db90ee22454e7a251fafaf7b5b583f0d432ee2f0"
"Constan-14","2021-05-21T08:40:46Z",0,0,0,"94d98cc7bc49502bb508b2948ca6018ba908d9cf"
"Constan-14","2021-05-21T08:40:30Z",13,6,7,"62e80a1a3bab9cc97f0c8f771a371607a48ca053"
"adrianlan79","2021-05-21T08:39:14Z",14,5,9,"5445a9ea5e52682417af94861c1fda3b06cb7cb9"
"adrianlan79","2021-05-21T08:38:57Z",0,0,0,"2f35ecec3f5407d1ac4556900c9bfedac71af28d"
"Constan-14","2021-05-21T08:23:47Z",14,5,9,"f93bf1d1ad83319cabef4bbaf2313ef4989131e1"
"Constan-14","2021-05-19T16:56:28Z",11,8,3,"95582a4c6da15d9bfde4125930fbb3091ca6a822"
"Constan-14","2021-05-19T16:56:03Z",162,79,83,"217ec5792d2d349aa336b161a4fc162bd6d04e30"
"adrianlan79","2021-05-19T16:28:41Z",10,7,3,"958381cdc4176ba1cbad1bc1c94ae08e427d650c"
"adrianlan79","2021-05-11T12:24:26Z",55,55,0,"25e9199d4a41d31ee6f7bb7e37864f3754c218d5"
"adrianlan79","2021-05-11T12:24:24Z",12,12,0,"05fe2f4c54e484dabe6867c1b9162ee25aadbadf"
"adrianlan79","2021-05-11T12:24:22Z",109,109,0,"9b87d78db40bcfc1676a6ec473957193b90d9064"
"adrianlan79","2021-05-11T12:24:19Z",86,86,0,"e91421a1344cdcbd3cd4794ccf418ce94dbf32c0"
"adrianlan79","2021-05-11T12:17:09Z",36,23,13,"18f485286b7c281214435f526345f9870d1abd2a"
"adrianlan79","2021-05-11T12:01:18Z",4,2,2,"90a8b89c0b0b445043cd099b917d3571c013f24d"
"adrianlan79","2021-05-11T12:01:16Z",6,4,2,"5c3e276f2f9dbf555dbd08d4d2e17ace106d232e"
"Constan-14","2021-05-11T12:00:45Z",4,2,2,"21dfa57bf97adf1aea4b565d07d7fb6c03fc9d11"
"Constan-14","2021-05-11T11:58:25Z",17,9,8,"9802629cd6bdfda1876813986fb9e16729bae847"
"Constan-14","2021-05-11T11:56:17Z",198,105,93,"4267117719faff481656b07f88a2cf8d39ea241d"
"adrianlan79","2021-05-11T11:55:54Z",14,4,10,"e947a4bf93d9e6c66c9fb4cc3c101f8045d40543"
"adrianlan79","2021-05-11T11:45:20Z",4,2,2,"7efec4e47f5703b0bddcf03a6f81b0c9c5d42eeb"
"adrianlan79","2021-05-11T11:43:21Z",14,10,4,"7abe54066891144ea25dbc20afde525ee2fca60a"
"adrianlan79","2021-05-11T11:31:36Z",16,9,7,"5473e01282e415c9f229515058f7813c3b6436d0"
"Constan-14","2021-05-11T11:13:57Z",97,93,4,"d5b40db1160500d14f6062f804fa1f6a9670820c"
"adrianlan79","2021-05-11T10:52:00Z",41,33,8,"4e939a4644e14abbb845ece04c3ea19bd1bf35d4"
"ruben1000iq","2021-05-11T10:34:47Z",0,0,0,"a5865b36c740b80750adf80f49cbcf4e241a5e9f"
"Constan-14","2021-05-11T10:34:30Z",109,0,109,"9f99476e5085e40d14726c0cfe1297bdf0d71e1e"
"Constan-14","2021-05-11T10:34:23Z",55,0,55,"b57e5f2e43e5d6e69b5234ccaedcfb510934e34c"
"ruben1000iq","2021-05-11T10:34:15Z",3,3,0,"e6422c5a04a0a381e806abc947c235423f821006"
"Constan-14","2021-05-11T10:31:47Z",0,0,0,"0a08ecc298911758eb6ed620da6bc1c93cff4a9c"
"Constan-14","2021-05-11T10:31:46Z",109,109,0,"5054053cf3a0ef894ba3d0ebaecc264f2cf09bfc"
"Constan-14","2021-05-11T10:31:07Z",1,0,1,"7c70b90f7b199edb186705d462400a2a28f215ae"
"adrianlan79","2021-05-11T10:29:10Z",1,1,0,"8641fecdeb00b32afaf018142a198e84cc648188"
"Constan-14","2021-05-11T10:28:42Z",55,55,0,"f062df7cf84739f7ac563d138b945f936deb67f4"
"adrianlan79","2021-05-11T10:22:03Z",18,9,9,"3b44d9b5ddc96eb3d2fd96da85b0826317dac5a5"
"Constan-14","2021-05-11T10:17:25Z",18,9,9,"d8e72757e903faeaca8035f1951d7fcd9c25d0c0"
"Constan-14","2021-05-11T09:59:33Z",4,3,1,"02b3849254206cec6f978fdeb85b4707adab3021"
"Constan-14","2021-05-11T09:57:49Z",6,3,3,"417ea09aa53590799ad654043124681bcc7d8d70"
"adrianlan79","2021-05-11T09:02:04Z",4,3,1,"8532fc4df0829e9895c208320d6214ee07097284"
"Constan-14","2021-05-10T21:56:26Z",151,90,61,"df3df7039c0743adac342da13879a830e29a617f"
"adrianlan79","2021-05-10T15:09:53Z",9,7,2,"9dcf038de340a4e22975f2569cfe1f033da805a2"
"Constan-14","2021-05-10T13:27:32Z",38,18,20,"08ce74f5849c82072903bc31a0973d37dbd18e99"
"Constan-14","2021-05-07T22:31:51Z",3,0,3,"04e708ad974754730b28ecba45e7e76e8b02a140"
"Constan-14","2021-05-07T14:37:25Z",162,76,86,"8e12bf3afc6accf795518b0a956b32c932ef3f0a"
"adrianlan79","2021-05-07T14:00:01Z",62,56,6,"6d5c488a38d8dc693927d6f4d3caae3a1649fb9f"
"adrianlan79","2021-05-07T13:51:16Z",18,11,7,"bffa34e836d91962589c9b5b865c8b78780d13b4"
"Constan-14","2021-05-07T11:47:36Z",75,40,35,"5ce430b91d7a8a0c854dac096b07e74788ec8a45"
"adrianlan79","2021-05-07T11:17:41Z",32,26,6,"723aa9699c3e79d8eda0d3167d658296f257e48b"
"Constan-14","2021-05-07T11:16:19Z",2,1,1,"c4db0eecddff0a7168e1c94efa86a4aae4f9e6a4"
"Constan-14","2021-05-07T11:15:38Z",31,26,5,"8ccc4d28bf2522fb254904c396f7b1a2a7471b5c"
"adrianlan79","2021-05-07T11:15:36Z",5,4,1,"02e4d22e9648c1c2861ba10a12bf35cf35cb8530"
"adrianlan79","2021-05-07T11:02:02Z",12,12,0,"e4077066fc03736e9b4bda8fd16804f172289363"
"adrianlan79","2021-05-07T10:51:06Z",5,4,1,"f899257319e5519c87fcc3b59bf2e7f9d238d8a9"
"adrianlan79","2021-05-07T10:31:26Z",10,5,5,"54248c703391f45adaf7b0580b14136480bfafee"
"Constan-14","2021-05-07T10:03:21Z",7,2,5,"fbf5ff2ac5aeaf3f1c256b4ac8a2a1f3dd2d469f"
"Constan-14","2021-04-28T11:54:37Z",1,1,0,"0fe55558b8888df272f000680eba1c09c560cc2e"
"adrianlan79","2021-04-28T11:43:39Z",28,28,0,"28922135cc52761a21ceef7db1f01fa1b48aa3ea"
"adrianlan79","2021-04-28T10:40:11Z",2,1,1,"4633d37edbeca0ffdfae790759acefc08d427bcc"
"Constan-14","2021-04-27T21:51:19Z",34,26,8,"73d9ef153b127fb5486498aa674a968cda3977f7"
"Constan-14","2021-04-27T18:13:32Z",61,28,33,"d5af836f7d89f6a884a5dd6c7a47d08d074a1f0c"
"Constan-14","2021-04-27T17:54:44Z",15,7,8,"d7ec581d3065e276a94d1d5fada552da86e91d99"
"Constan-14","2021-04-27T17:35:40Z",224,95,129,"3e518ad10708df7c403ecd2a33a61bf78d103b42"
"adrianlan79","2021-04-27T16:43:07Z",123,111,12,"82a27c07b16323fa1cc5b25eb13cee976203a2aa"
"adrianlan79","2021-04-25T18:00:21Z",15,10,5,"1d4ba9505ba18f7eab360e6de8fc56be5cc4d411"
"adrianlan79","2021-04-25T16:04:20Z",10,9,1,"0275272d88a3d07ddd7f1db09c045b1ac120c586"
"Constan-14","2021-04-23T11:12:59Z",5,3,2,"f2fca7a5abbe9bffbc6d41159e3d0f3f16b4aece"
"Constan-14","2021-04-23T11:12:56Z",223,124,99,"0d2d8155863967703f75104bb75ca3f2384c67ea"
"Constan-14","2021-04-22T11:37:27Z",1,1,0,"74cfd90a6bfeda5e3cb69375af851671ae65d42d"
"Constan-14","2021-04-22T11:37:11Z",4,2,2,"426ec2e9dff3fed26232c1ba1aca3abd28343374"
"adrianlan79","2021-04-21T11:29:21Z",49,49,0,"e34fa7aad60249c65460e5e46bc4667113619de9"
"adrianlan79","2021-04-21T11:00:26Z",23,12,11,"ce148c2675a1dd6550f5983c5d80324e112b0ee0"
"ruben1000iq","2021-04-21T10:45:58Z",2,1,1,"5a450eb9e92dc81af02f577bfcb706f26a5802da"
"ruben1000iq","2021-04-21T10:45:38Z",2,1,1,"0f7e702cd1cf99028e1d87497f10dcd1c5a5e6da"
"adrianlan79","2021-04-21T10:43:04Z",2,1,1,"9ed34a18604803f0a1c54c03ea485a5ae2fa4c76"
"Constan-14","2021-04-21T10:31:18Z",4,2,2,"4a1a504210951ed53d9cf39322fd853594a17965"
"Constan-14","2021-04-21T10:26:49Z",3,1,2,"bfc2736e242424014564a14f30d5f14eb14f3097"
"Constan-14","2021-04-21T10:26:31Z",4,3,1,"763a8f6b175ae1eca2f005435c2e1de0147ae7ef"
"Constan-14","2021-04-16T08:22:12Z",16,12,4,"ded2d848f0b11423b78b49b7903f710752405e00"
"Constan-14","2021-04-14T11:31:00Z",24,18,6,"63a8ceae1406a0dce5ab90aeeb2bbc4bec45703f"
"Constan-14","2021-04-13T18:14:45Z",2,1,1,"9d6231ca7c82290b6b54c205351eff60a798471b"
"Constan-14","2021-04-13T18:04:32Z",5,2,3,"e8a125445cb72b966c3af9399f4138138d3203e7"
"Constan-14","2021-04-07T10:09:20Z",0,0,0,"58e37c62e009103476c640740ed1d4649d516522"
"Constan-14","2021-03-25T15:24:24Z",60,60,0,"c89913a9e970b8682b4142e00a6f09d385456994"
"Constan-14","2021-03-25T14:42:13Z",2,1,1,"6629041347825df4616b4d4bb9fa5ca16df8a477"
"Constan-14","2021-03-25T13:16:51Z",2,1,1,"719aee6add01f7a57ac530461af0a6f41fbcb2cc"
"Constan-14","2021-03-24T11:15:09Z",2,1,1,"e633f2cdeb9af266aed0ea2abe5c8cc727924e4f"
"Constan-14","2021-03-24T11:13:39Z",3,1,2,"4a52bed2826a1e70b45aa269ea048b8cd44719a5"
"Constan-14","2021-03-24T11:09:13Z",1,1,0,"250624db7a7d153df206c6c1a0ac0d048ae32278"
"Constan-14","2021-03-20T10:35:54Z",4,3,1,"a97846b89e4e66fade664bef5cd947c1b82c3da2"
"Constan-14","2021-03-17T12:18:13Z",6,3,3,"785c7a69be880f3e7081e07cedfe6918c3f3860c"
"github-classroom[bot]","2021-03-17T12:09:45Z",737,737,0,"2e654811491cc90b6a845a87606b6ad745b3ea33"
