"name","date","total","additions","deletions","sha"
"mballard02","2021-05-28T17:11:08Z",2,1,1,"5e5e08d8321a45019e2e862028845f3af7ff6f79"
"silviaacc","2021-05-27T16:37:19Z",15,6,9,"c75980a39d1dfd7731e0ec797c4ce094eb4b73b4"
"silviaacc","2021-05-26T13:03:06Z",2,1,1,"99307bc0e18063efbb5e774dd3b7b93a108bee90"
"ruuthdlf","2021-05-26T11:37:49Z",0,0,0,"4c834f8afa9713dc41b92cf337b807757dddd800"
"mballard02","2021-05-26T09:42:24Z",0,0,0,"0c1ba3c1f74c74195b834180c7f0f20af9924669"
"mballard02","2021-05-26T09:36:34Z",4,2,2,"39c754c6ceb83a88b6b318334c8773f4aac12cbb"
"mballard02","2021-05-26T09:36:14Z",0,0,0,"2234e1e3fe7ab4576a6732dd6d41b77878c02da8"
"ruuthdlf","2021-05-26T09:32:11Z",0,0,0,"361f86e256fa7573c0a2cc33a4cae181b1b36f5c"
"silviaacc","2021-05-26T09:22:20Z",4,2,2,"d99536e015090f397bbdcea982e3be3d352b4c46"
"mballard02","2021-05-26T09:18:33Z",46,25,21,"112ef789dea6ae23b0711a1ca149144fb3296e3f"
"mballard02","2021-05-26T09:18:26Z",0,0,0,"a241e85056d073ea791a47a590cffa8f8c8a038f"
"silviaacc","2021-05-25T16:34:27Z",24,17,7,"f548aebf138548ad3d5e0f5c55db2a9daeb875f0"
"silviaacc","2021-05-25T16:22:11Z",1,1,0,"d8ece707e3e4eb2e1ab106025dc4db30f4a463a6"
"silviaacc","2021-05-25T16:21:14Z",13,5,8,"cdec47faf481efaede8a9c4657df90d600a504db"
"silviaacc","2021-05-25T15:58:35Z",22,9,13,"aa2c6fbbbcf5b487b675d7c602aaa4c8c8be0663"
"silviaacc","2021-05-25T15:52:11Z",0,0,0,"03b350a158576cac3b8964a936daa3306e9a2d3e"
"silviaacc","2021-05-25T15:38:13Z",0,0,0,"c628be34111467b1b8f3c4b357bf358f2a2dda3e"
"ruuthdlf","2021-05-25T15:32:41Z",0,0,0,"a7bf766c0061a8537060e5ee3741c1ea5cbb4e25"
"ruuthdlf","2021-05-25T15:32:13Z",0,0,0,"22e36d61f66da9a72220e3c886327bc22c698ad4"
"silviaacc","2021-05-25T15:29:43Z",0,0,0,"9e4ae6cda68f9cf3d85bae645150da7ecb4e4379"
"silviaacc","2021-05-25T15:12:22Z",0,0,0,"851eeb05e700992b571b5575cdd721bc03116106"
"silviaacc","2021-05-25T14:51:10Z",0,0,0,"4eb9a7688f0b327ade44d8b6036cf210edf2c463"
"silviaacc","2021-05-25T14:44:21Z",0,0,0,"aeff46a415cc1e70b42ec21584be2bf3604ed898"
"silviaacc","2021-05-25T14:41:52Z",1,0,1,"5719c94b96b9ba20d8dce82ac9b91c0f9536faae"
"silviaacc","2021-05-25T14:41:22Z",1,1,0,"05ab2263963ed0e5079a986225774c9153bcbabf"
"ruuthdlf","2021-05-25T14:34:05Z",0,0,0,"6ce70ac5f502601b70ba8d9d022e2fc596ef39b2"
"silviaacc","2021-05-25T14:30:06Z",1,0,1,"dd8d37662f56fb686c7c82777f6d23505c853ed0"
"silviaacc","2021-05-25T14:29:36Z",1,1,0,"acb99bacc441305b40ef5ade745d3ce69fe30a8a"
"mballard02","2021-05-25T14:21:13Z",0,0,0,"16c5898e40acd0afb90ecb2ea76eaaccc515c704"
"mballard02","2021-05-25T14:20:53Z",56,29,27,"9fdce9e59c07a2b5edfa3f093f6982e3b21a5f11"
"silviaacc","2021-05-25T13:01:23Z",13,2,11,"14ec02e85106401eb1e7d13c09355d68d0d6cb8d"
"silviaacc","2021-05-25T12:48:02Z",4,2,2,"8996e5205717316cb69a19572f01936aca59e97d"
"silviaacc","2021-05-25T12:46:36Z",10,6,4,"a99e09b7026f1ebcea94ba6011781a1e57bb18ce"
"mballard02","2021-05-25T11:59:53Z",0,0,0,"926a72f34e1fd7f8885430b4c7da7228c8c201c4"
"mballard02","2021-05-25T11:32:18Z",54,29,25,"5984b9ab6daae80711121a67ca7a68a7ccabb8c1"
"ruuthdlf","2021-05-24T15:36:07Z",28,14,14,"559233e61cea23d0f654cf97a13c5bd3cfcbdb3d"
"silviaacc","2021-05-23T19:00:58Z",8,4,4,"265519aee04fb00d81c041f6c6ba47400c6360db"
"silviaacc","2021-05-23T19:00:22Z",8,7,1,"dc22a9155bc115cd94fb52a700ff389b41228030"
"mballard02","2021-05-23T18:55:21Z",9,0,9,"9a45ce3a2ca714f76769065cbc66ad43b1827a10"
"mballard02","2021-05-23T18:52:36Z",24,24,0,"5f8868aca831ca00ae5205edc2a787873423b65e"
"mballard02","2021-05-23T18:29:48Z",0,0,0,"be133ec28e81630d71b8b028239222a64b127b42"
"mballard02","2021-05-23T18:29:28Z",104,64,40,"5fcf85052b424d6ec2a825af649c80d27ce1b98b"
"silviaacc","2021-05-23T17:07:56Z",15,15,0,"9a4252124efc105bb5ba2d88c222a5efb1f8ad07"
"silviaacc","2021-05-23T16:55:44Z",15,15,0,"2127f2dfc5cc4a646b9ad12a229dd9b18b2cc083"
"ruuthdlf","2021-05-23T15:31:15Z",23,19,4,"143b9cf50d6b3aa163d23d4685c0c6f34bea6938"
"ruuthdlf","2021-05-23T15:01:24Z",0,0,0,"36fff5fc95d566b93620c8ece488b8654cd26da0"
"ruuthdlf","2021-05-23T15:01:03Z",128,0,128,"ca39e25b8ff7d3530bf22562d86a0dc5a4caaeeb"
"ruuthdlf","2021-05-23T15:00:51Z",27,0,27,"5917c354bea8e58d665643ffacf039971db601e0"
"ruuthdlf","2021-05-23T15:00:40Z",0,0,0,"3c55643b3c549b74221428ade24bce6dab51d155"
"ruuthdlf","2021-05-23T15:00:21Z",418,0,418,"807b44f0c113d1dfc17084baf60017568a50d34b"
"ruuthdlf","2021-05-23T15:00:12Z",422,0,422,"9de48c34ce7467bd83b87dedbc1aac2d2889c11d"
"ruuthdlf","2021-05-23T15:00:03Z",17,0,17,"10cc5b50df86be5bb06e318396eb810df42989b5"
"ruuthdlf","2021-05-23T14:59:52Z",391,0,391,"4b89e5a67456f437cc31eaffbc60fbe5e4f54af7"
"ruuthdlf","2021-05-23T14:59:41Z",119,0,119,"ce14e0c4bb38d2c3604a1860ddc3987c79239acc"
"ruuthdlf","2021-05-23T14:59:32Z",381,0,381,"b09e5b883ab292573f8659d00a8e17c9819e1706"
"ruuthdlf","2021-05-23T14:59:21Z",390,0,390,"9730a8f1a8eb8dab41e9ecfd5bd24a63263b24fb"
"ruuthdlf","2021-05-23T14:59:09Z",96,0,96,"4b2b3d7d12104b33a01ead7976a50cb1dd76351c"
"ruuthdlf","2021-05-23T14:53:03Z",430,426,4,"55a0e61d10f9dac2f43fbe5241d3be2ddfe35c44"
"ruuthdlf","2021-05-23T14:51:10Z",2504,2413,91,"ebbd378953e53f80e6ae5165699b9cbe430b2211"
"mballard02","2021-05-20T19:21:34Z",4,2,2,"2dcc9df7d9c3b87e782244066ed585ef8a12aa3d"
"mballard02","2021-05-20T19:09:08Z",30,19,11,"759aa54cd13529daf1aa2b92c6bbf119e7cdf4eb"
"mballard02","2021-05-20T19:00:34Z",733,380,353,"918cf61d126fdb1fdf55585a1801d24c8f01a6d0"
"mballard02","2021-05-18T19:23:37Z",1,0,1,"b06744cd907cf0ffc8375e50c48a1969a2ac7dae"
"mballard02","2021-05-18T19:22:15Z",1,1,0,"f4184cfbdfda61a94ccce60c42e732306d45a301"
"silviaacc","2021-05-15T19:35:27Z",16,11,5,"ead0f81983693023d1c567d6339205bb645d496e"
"mballard02","2021-05-15T08:02:50Z",6,3,3,"fffb3d2ba8b43146763af5968a5e14388c5e390e"
"mballard02","2021-05-14T20:49:18Z",20,9,11,"963e3185518b78ee839abd4bf9ca9ab229cf5720"
"mballard02","2021-05-14T20:13:36Z",99,46,53,"162b0d6addcfe60b45b02f8833fe3e21d8507560"
"ruuthdlf","2021-05-13T17:32:12Z",0,0,0,"5cc40ee45424516f7719f77df8b58b8940f4b8d1"
"ruuthdlf","2021-05-12T17:28:08Z",2,1,1,"2f58212b2717d738efba04a1d36dd249f507477e"
"ruuthdlf","2021-05-12T17:27:06Z",192,80,112,"93879ad6d28ebaf1fbf7c95f982a192671d79294"
"ruuthdlf","2021-05-03T15:21:05Z",23,21,2,"b03703c5305d5bdef80b5ce2fa6d41a5a7c0e4f5"
"ruuthdlf","2021-05-01T11:14:34Z",2,1,1,"76134021328928d2ddd00569773deb6a5ab3c058"
"silviaacc","2021-04-30T10:07:07Z",14,7,7,"1ca8983eac658a909ac1a8edaffbeb84b90dbd3b"
"silviaacc","2021-04-30T09:51:49Z",6,3,3,"95d0273797667165fd0172c766da5e8a0104f2c1"
"mballard02","2021-04-30T09:35:00Z",21,21,0,"94e6bdfc53ab4d2cf3ecd0a5b4f3c906184a1733"
"silviaacc","2021-04-29T18:32:48Z",6,3,3,"1b503b151c3b207c6fb45b90072179684182b1f0"
"silviaacc","2021-04-29T18:30:49Z",9,9,0,"58976621d0de69ce7f567189e0d176e914bad6bc"
"silviaacc","2021-04-29T18:29:03Z",318,237,81,"22761d45562c3dbdd8ee9c702faf7bce166ddbf6"
"ruuthdlf","2021-04-27T08:11:42Z",200,147,53,"cba49107ac069a5daa9971fcba548f8e4ee84055"
"mballard02","2021-04-17T19:48:56Z",66,64,2,"8d9fc77d5d36adbfe45949eb6b3c308d82f09fe5"
"silviaacc","2021-03-24T11:09:55Z",0,0,0,"2c6c6a835fbe77399f6a322b96b3f0a0dbee1456"
"silviaacc","2021-03-20T19:43:26Z",91,91,0,"91082676060f8f76afb5a4ffed39e9b5e09241f7"
"ruuthdlf","2021-03-16T12:58:00Z",6,3,3,"2778f38b5ba7dda3d71381f18771dee4b8c08a9b"
"ruuthdlf","2021-03-16T12:57:05Z",18,14,4,"24f4b2ea5a8ffb7cf50f423875c4d7ba5d4562fa"
"github-classroom[bot]","2021-03-15T16:12:23Z",737,737,0,"13d6e372f9e72e4ca03ed271fb5bbbcdbc2796f2"
