"name","date","total","additions","deletions","sha"
"DiegoBastida","2021-05-28T18:28:24Z",0,0,0,"6e349c9909e53ce312e55bec124baf4d551494d9"
"DiegoBastida","2021-05-28T18:28:14Z",4,1,3,"4307cc4bc370b97542ae9eff0a012db103d19afd"
"ignaciocartes99","2021-05-28T18:22:57Z",0,0,0,"9bb2d8c4e3da3088fcc13a9c34f1a6ea81563460"
"DiegoBastida","2021-05-28T18:15:24Z",0,0,0,"2973c133c6c21e50bca42cee79c48ee30649061b"
"DiegoBastida","2021-05-28T18:15:09Z",33,9,24,"a6d9955207757ce2de9316c19fb8db658a58425b"
"ignaciocartes99","2021-05-28T18:13:07Z",0,0,0,"fd7b531fa8c30fcdad2f5be6288d0b33a34aa3a4"
"ignaciocartes99","2021-05-28T18:09:33Z",0,0,0,"6f8d3f552bf72ac101fdfbbc258417a4a4e133ab"
"ignaciocartes99","2021-05-28T18:08:29Z",0,0,0,"99fcf44f41c789050e31dbc8c7c1a110a6d23491"
"ignaciocartes99","2021-05-28T18:08:12Z",0,0,0,"866fa00d196b5e7b9028e353503c0e97789efebd"
"ignaciocartes99","2021-05-28T18:01:16Z",2,1,1,"fb90f18cbf55c6a044794272aa27685d1e0d2229"
"ignaciocartes99","2021-05-28T17:57:58Z",2,1,1,"59a20a65dc198e415d9d9cb111b104210705ee4e"
"Diego Fernandes","2021-05-28T17:56:28Z",27,10,17,"fce68280435296393f438d402d36949dc765609c"
"Diego Fernandes","2021-05-28T17:51:15Z",3,3,0,"fa439fb11c2f0fa67fb5f527f983048c3bec3a3b"
"Diego Fernandes","2021-05-28T17:47:35Z",2,1,1,"188944414e9fd6818bcd0a3e63fe377ae4cfb853"
"Diego Fernandes","2021-05-28T17:47:31Z",745,371,374,"5f6a232c184e78bd7614eaec6898b92162703bcb"
"ignaciocartes99","2021-05-28T17:39:58Z",0,0,0,"5c2c11128445d80e59fe08dbc45bc72e9de13bec"
"ignaciocartes99","2021-05-28T17:39:23Z",0,0,0,"f822b815e5bff92c4db19d5b4a45c9c2cc8ce376"
"ignaciocartes99","2021-05-28T17:39:01Z",0,0,0,"1695877f7aecb5252afb5af5db5bd3fdf21347e7"
"ignaciocartes99","2021-05-28T17:38:28Z",0,0,0,"a982f0ff896ef5b44818b29e99ac293bf5aaec89"
"DiegoBastida","2021-05-28T17:20:15Z",2,1,1,"5de1de5705b3816f9e3ecfca5e325cc946ff17e8"
"DiegoBastida","2021-05-28T16:02:01Z",276,51,225,"c9e741d1c8b4821b00b000a84d13a387cab3800d"
"ignaciocartes99","2021-05-28T07:44:22Z",16,0,16,"655d8ae7a4357f9452d7dbe19d4eb407cb2e4446"
"ignaciocartes99","2021-05-27T09:58:50Z",1,1,0,"3999c7fbc35ba390d63a74a1f011b00079b6233e"
"ignaciocartes99","2021-05-27T09:58:32Z",1,1,0,"26f33164cf3841a326e61983ea1f3c54dd2deb0d"
"ignaciocartes99","2021-05-27T09:58:05Z",2,1,1,"d04c3fbabd4ecb128902fe901d6049ddf7627485"
"ignaciocartes99","2021-05-27T09:54:32Z",20,20,0,"8e279bea5de6461b2c33cd6c0460923856da07b5"
"ignaciocartes99","2021-05-27T09:54:15Z",3,0,3,"9c752626eba680c93e6b29cf21f7f675807a3a3b"
"ignaciocartes99","2021-05-27T09:54:05Z",16,0,16,"8a042d0a1c2cd7a46cdd11a18a5a9803ee217361"
"ignaciocartes99","2021-05-27T09:30:43Z",11,6,5,"a0561a86fbf18ee1f91bf5a07463fbef1afd93e1"
"ignaciocartes99","2021-05-27T09:29:01Z",142,120,22,"430ee5beb93e516cccd28f4d76f2b20e25b642cd"
"ignaciocartes99","2021-05-27T09:19:38Z",6,3,3,"0d13fba3852812ab061f67d291ea25afd87e1349"
"Diego Fernandes","2021-05-27T08:49:19Z",43,41,2,"9a2ee9d468d119b026fbe8d1d0c15b03b7211ce4"
"Diego Fernandes","2021-05-27T08:33:20Z",8,5,3,"bbf496fff69a86c2a4cb56ab9cd2895aaae24c5e"
"Diego Fernandes","2021-05-27T08:18:44Z",11,4,7,"b740bd03635acd67590366a8f611d7868dce5347"
"Diego Fernandes","2021-05-27T08:10:05Z",111,50,61,"4cf954ed0a9c76bd297af9ca6f3b4aaa24cb8e0c"
"Diego Fernandes","2021-05-27T07:49:49Z",21,10,11,"f8bbfbdc8de448dd4b8a94968f56f27c57faae29"
"Diego Fernandes","2021-05-27T07:44:01Z",18,9,9,"f3fb7fac43382e027212450a865890015460e426"
"DiegoBastida","2021-05-27T07:32:40Z",2,1,1,"52d17ad2973a548252eba9a510a9dea4fbef1879"
"DiegoBastida","2021-05-27T07:26:33Z",5,4,1,"a61d15861f0d901d0fa13a1483c1a41f8bfad9c3"
"DiegoBastida","2021-05-27T07:26:24Z",284,0,284,"728621d833caac7205a879645757b07374383af3"
"Diego Fernandes","2021-05-27T07:24:39Z",0,0,0,"4f0709cc93f5b50801e2e3690e5d29b1720e2b04"
"Diego Fernandes","2021-05-27T07:24:29Z",5,4,1,"361c379add18d56bd5b91a5445f265b995988134"
"DiegoBastida","2021-05-27T07:24:16Z",0,0,0,"2f3971d83312462537ea1bb36398835de6be4d2e"
"Diego Fernandes","2021-05-26T23:21:03Z",3150,2856,294,"01cc7821b800006395c6b7a36eb9114d5981b682"
"DiegoBastida","2021-05-25T17:05:26Z",298,297,1,"4bf37539e55891abff3cad34c807974763a4deee"
"DiegoBastida","2021-05-25T07:12:03Z",5,4,1,"26a37c473e68cc5b223e342b77b7d8bd82791c81"
"Diego Fernandes","2021-05-24T21:59:53Z",119,72,47,"bdf97e7dd3a37d04bdf8a6241b14f6d1a8bf5ed1"
"DiegoBastida","2021-05-24T17:20:40Z",431,393,38,"b4a72adea171613d93d9bcc75a56ad6053e50db4"
"Diego Fernandes","2021-05-24T11:09:40Z",1169,1041,128,"3f7225ca6e7be92fe1cae86526a075a442603444"
"Diego Fernandes","2021-05-23T16:53:13Z",68,53,15,"379e776f200a91778b7c6233efd3efe90828881f"
"DiegoBastida","2021-05-23T15:24:04Z",81,49,32,"21e36c6aad8786aba94717a4c8efd6ea6e6eded7"
"DiegoBastida","2021-05-23T15:24:01Z",312,287,25,"e2588f1cfa429499ace4734f6a9b480fae54024f"
"Diego Fernandes","2021-05-23T11:30:19Z",80,43,37,"b4caeae0f4def89a143f27696b8c68fb85ba9dd3"
"Diego Fernandes","2021-05-22T14:31:41Z",41,26,15,"2de755bc9751b937a212f3a2d3b8ee9817a58e3f"
"Diego Fernandes","2021-05-18T20:19:37Z",31,30,1,"a593157017fe88eb403e3d20e9c6f3e97e3b2e80"
"ignaciocartes99","2021-05-18T11:45:08Z",0,0,0,"04f3d7272bd9f048e2189a38e5634eb510d43225"
"ignaciocartes99","2021-05-18T11:44:29Z",2,1,1,"89f556165057d8b24740457b454be05f1b471c00"
"ignaciocartes99","2021-05-18T11:38:31Z",35,35,0,"ea645f7d0d099cdd1d789d910f9f5e041372e518"
"ignaciocartes99","2021-05-18T11:36:31Z",8,4,4,"a8412357f0ef5c8c78d4e57bb3d9095549f42506"
"ignaciocartes99","2021-05-18T11:34:06Z",7,7,0,"533d43f5413b34b4d3bc20f5dbd6259afe98cdd2"
"ignaciocartes99","2021-05-18T11:33:29Z",183,183,0,"f25cabeb5d95652d9a48721bfd48fca73d182b75"
"ignaciocartes99","2021-05-18T11:28:11Z",2,1,1,"89d9420ab8dbaadbd6ec86bc2defc74c98939dfa"
"Diego Fernandes","2021-05-14T15:59:16Z",52,38,14,"4968ab3f58259b8de2f267fc3c00b36ccc10a38f"
"Diego Fernandes","2021-05-13T21:31:39Z",36,31,5,"562b7ccf59f24481e50476da4a7a7dfdb0761f5b"
"Diego Fernandes","2021-05-13T18:56:09Z",9,5,4,"74a5594014b307ecb280ea7f68d90bff6af6f47d"
"Diego Fernandes","2021-05-13T18:46:55Z",2,1,1,"5d46da5f9fb060e18084e67a6b7aca220422c681"
"Diego Fernandes","2021-05-13T16:13:09Z",4,0,4,"30eaf5862dc374957cc62c734dade108ed74d23a"
"Diego Fernandes","2021-05-13T16:11:08Z",93,93,0,"3bdcfc7aa9542c4ffec340fdd803242bc20eff67"
"Diego Fernandes","2021-05-13T15:54:12Z",56,49,7,"afc2798dedc6abc8ae9e732cd639909150f97c38"
"Diego Fernandes","2021-05-13T15:53:55Z",2,0,2,"eeb43bbe86c11987aa6d84baef35db4fa58e3ffa"
"DiegoBastida","2021-05-13T15:38:49Z",56,49,7,"a3cfedb23241b22822c2d4c0dd57acda76c77bbd"
"Diego Fernandes","2021-05-13T11:23:20Z",2,0,2,"5f97385402c46ad0a5c2ccdcc5830e03ad906a93"
"Diego Fernandes","2021-05-13T10:50:02Z",103,44,59,"2ea76e01788e099a1bcedc11ea0a0a60f5e3d98a"
"DiegoBastida","2021-05-12T18:29:49Z",119,119,0,"a55bbc47afc4c72769bd039140cc1c210e778075"
"DiegoBastida","2021-05-12T18:26:20Z",118,5,113,"a230c5baf3b42d07ff92767cb4f777709112f8b3"
"ignaciocartes99","2021-04-21T11:08:30Z",237,150,87,"189ad39a7c03afaa31d20d55e9eabfa82f832f33"
"ignaciocartes99","2021-04-08T16:13:51Z",0,0,0,"2460e184cab9e8db7574edf260a952ed4a98568a"
"ignaciocartes99","2021-04-08T16:13:15Z",0,0,0,"58503eae3d5475f527c5f214919c1e51e03d63c9"
"ignaciocartes99","2021-04-08T16:13:00Z",0,0,0,"115792222e8ded09ae11b725998795162496e5e5"
"ignaciocartes99","2021-04-08T16:12:43Z",0,0,0,"457acd757d9df1c09b308ec886e32e66de07a25b"
"DiegoFernandesAlves","2021-04-08T14:48:46Z",67,42,25,"19e77a34d476f45ccbece6b129ede1cf96ebb843"
"DiegoBastida","2021-04-08T14:26:10Z",0,0,0,"ec0611a21601697ac2d00368ad92809467b6afab"
"DiegoFernandesAlves","2021-04-08T13:52:13Z",0,0,0,"f2fcd7419a17e4038a26a1affb3db426a63644f9"
"ignaciocartes99","2021-04-08T11:44:41Z",0,0,0,"e66fb680f6e460cec41aa026ccde5bd14df3ce8b"
"DiegoBastida","2021-04-08T10:36:55Z",37,35,2,"0e38713980ce8fac483cdcdcea4535a99cf3e0b7"
"DiegoBastida","2021-04-08T10:36:21Z",37,2,35,"b2f2c7bc3642067c822f29e4eb974cf670f2382f"
"DiegoFernandesAlves","2021-04-06T12:01:10Z",37,35,2,"1522b31ed17f3564646d0b73d16f9bef4c1699f5"
"DiegoBastida","2021-04-06T11:47:03Z",43,43,0,"ab049f44ee03c7ee0fee59aeed6c365ca87cf88c"
"DiegoFernandesAlves","2021-03-17T10:44:05Z",3,2,1,"6abbb25c716b570a591107af9475c7c00ba55c4b"
"ignaciocartes99","2021-03-17T10:30:10Z",9,1,8,"b2f53806317bad050d98e4f369e9aa5d4aa007d6"
"DiegoFernandesAlves","2021-03-14T08:43:05Z",8,0,8,"4edfb904e619bf9a932a6cca8899811ef6f9fb8b"
"DiegoFernandesAlves","2021-03-13T20:16:05Z",2,1,1,"1bedcad75c9df748c09fe971273e7fca0b16e3b9"
"DiegoFernandesAlves","2021-03-13T20:15:53Z",2,1,1,"84538caabf8c95b39a975e51ca2a84702cb12d5f"
"DiegoFernandesAlves","2021-03-13T20:13:05Z",2,2,0,"8877cf2347538164f930f8ba7b150931907eb552"
"ignaciocartes99","2021-03-13T17:23:23Z",2,2,0,"d475a942d80e5d9bdc7ad8f2fce755c0ed519ce1"
"DiegoFernandesAlves","2021-03-13T16:29:42Z",4,2,2,"8cee3f2c2d697e5a57a37a04e2fbfcc24dc76238"
"DiegoFernandesAlves","2021-03-13T16:25:05Z",4,2,2,"9a561dacb07a7d55b07d9544d7f2c4a53eb0dfb8"
"DiegoFernandesAlves","2021-03-13T16:21:33Z",7,4,3,"af3be2774965e8487ed9a58868853e7ca1b3a5ad"
"DiegoFernandesAlves","2021-03-13T16:14:23Z",4,2,2,"674812affb196695f1262fb40dea34bebff54139"
"DiegoFernandesAlves","2021-03-13T16:11:34Z",4,2,2,"93d3170449af0450e0d30046a126094138d30ca0"
"DiegoFernandesAlves","2021-03-13T16:09:59Z",9,5,4,"abd89f862b3231dae74ecf420d59e8de4b49c082"
"DiegoBastida","2021-03-12T15:37:50Z",2,1,1,"ea0deb8d583c2c96a53c1450680dab18fbb84655"
"DiegoFernandesAlves","2021-03-12T15:32:01Z",2,1,1,"aec82450404a8b06faaee122a713fc3182a4433f"
"DiegoFernandesAlves","2021-03-12T15:27:35Z",7,3,4,"38b07d7f6b70c300847cfe2f7269f36c90df272d"
"DiegoFernandesAlves","2021-03-12T15:25:04Z",3,1,2,"ca65327d566a5bc7932cdcf6270a09dd174a320c"
"DiegoFernandesAlves","2021-03-12T15:24:22Z",9,9,0,"2b3fa53ca040a8a60398fc895835cae39e7fbd84"
"DiegoFernandesAlves","2021-03-12T15:19:06Z",2,1,1,"0417bf0fc4ace930ee8da163a7113ce51775055b"
"DiegoFernandesAlves","2021-03-12T12:54:28Z",0,0,0,"446e05e5cdfc901b62ccc54ccbac12f155268bf7"
"DiegoFernandesAlves","2021-03-12T12:54:04Z",0,0,0,"afba25d21910c6da3733dbb083aec7798613ba3a"
"DiegoFernandesAlves","2021-03-12T12:53:38Z",0,0,0,"e34a5ff581d145a9fb357a26d8c7dd066b7714eb"
"DiegoFernandesAlves","2021-03-12T12:48:50Z",15,6,9,"2d2f7d3c5767552a2e9632de45a96f3575ffdf12"
"github-classroom[bot]","2021-03-12T12:27:30Z",737,737,0,"90ee26d48ed3224bf696f7933674823d27b199a6"
